compaction_on double_probing 2551

1111111111111111101111111110111101111111111111111101111101111111110111111111111111111111111111111111
1111111111111111111111111110111101111111111111111111111110011111001111111111111111111111111111111111
0111111111111111111101111111111111111111111111111111111111111111111111111111111111101111111111111110
1110111111111111110111111111111111111111111111111111111111111111111101011111111111111111111111111111
1011111111111111111111101111111101111111111111111011111111111111111111111111111111111111111111111111
0111011111111111111111101111111111111111111111111111111111111111111011111111111111110110111101111111
1111111110111111111111111111111111110011011111110111111111111111111111111111111111111111111110110011
1111111111111111111111111111111111111111110111111111111111110111111111011011111111111111111111111111
1111111111111111111110101111111111111111101111111111111011111111111111111111111111111111111111111101
1111111111111111111111111111111111101111111111111101111110111100101111111111111101111111111111111011
1111111111111111111111101111111111110111111111111111111111111111111111111111111111111111101111111111
1011111111111111111101111111111111111111111111111111111111111111111010111111110101111111111111111111
0111111011111111111111110101111111111111111110111111111111111111111111111111011111111111111110111111
1111111111111111111111101111111101011111111111101111111111111011111111111111111111111110111101111111
1111111111111111111111111111111111111111111111111111011111111111111111111111011111110111111111111111
1111111111111111111110111111011111111111111011111111111111111111111111111111111111111111111111111111
1110111111111111111101111111111111111111111111111111111111111111111111111111111111111111111111111111
1101111110111111111111111111011111111111111111111111111111111111111010111111111111111111111111110111
0111111111111111101111111111111111111110111111111111111110110111110110111111111111111111111111111001
1111111111111111101111111111111011111111101111111111111111111111111111111111111111111111111111111111
1111111111111111111111111111111111101111111111010111111111111011111111111100111111111111111111111111
0111111111111111111111111111101111111111111111111111111111111111111110111111111111111111111111111111
0111111111111111111011111111111111111111111111111111111111111111111111111111111111111111111111111111
1111111111111111111011111111011110111111111111110111111111111111111111111111111111111111111111111111
1111111111110111101111111111111111111111111111011111111110111111111111111111111111111111111111111011
111111111111011111111111111111111111111111111011111

1101001110101110111111111111111101011011111010111100111100111110111110011111111111111110111111111111
1111111111111110101111111111011111111100100111111111011000001110011101111110011101111111111111111111
0111111011111111111101111111111011101111111011111011111011100111111110111111111001001001111010101000
1110111111111101111111111110111111110111001111111000110100111110111101011111111110011111101111110111
1011111110111111111110111110100111111111111111111101011111111111111111110111111111110110111101011000
1101011110010101101110011111111111110001111111111011111111110011101111111111011101110100011101111100
1111111111110110110001010011001101110111010110010111111110111110011101110111111111111011001111111011
1111111111110111011110111111111111111111110111101011011111101111001101011011111100101111111011111101
1110110010111111111101100010111111011100101001101111111011111110101111010001000110110101111111110100
1101111111110101111110111110111111001111110111010101111100111100011111001011111101101111010111111001
1111111101011101111110011111111110011111111111100101101101111111111111111111001011111101111111111111
0111010111111111111011111011111101111110101011011111111011111010011110111111110101111111111111111011
1011111011011111111111111111011111111111111111110010111111111111111111111100001111011101111111101110
1001111001111111111001101111011101011001011110011111111110011111111111011111001111101111101101100101
1011011111111011100110111111101001110110111011111111011010110110111011111111001010111111101001010101
1111011101010111101110111011011101111111111010111100010111111111101111111111101111110111111111110011
1111111111011101110001111111111110011111111011101111111111111110000110011111110111111101110110111110
1101111110111101111110111111011011111111111111110100100111111011110111111001011111110111111111110111
0111011111110111111111111011111101111110111001111111101110111111100100111111111111110111111110101111
1011110110011111111111111001111111111101101111100111001011111011111101101111111111111011111111011111
1101111111111100111111111111111111110011111111111111111111011111111111111101111111110110011111011111
1101111111111111111011101111110110011111101111011100011111111111111111111111011110111111111111111111
0111111110111101101101111111111111011111011101111101110011110111111011111111000111111110111111111111
1111011011111111001011111111011101111100111111110101111111101111111111101111101110111111111111111111
1111111111110011001111111110110111111011101111101101111110111110111111110111111111111111101111011011
111111101011011101100101111110011011011111111011101