compaction_on single_probing 2551

1111111111111111111111111111111111111111111111111111110100111111111111001111111111111111111111111111
1111111111111111111111111111111111111111111111111111111111111111111110100111111111111111111111111111
1111111111111111111111111111111111111111111111111111111111111111111111111111111111111111111111111111
1111111111111111111111111111111111111111111111111111111111111111111111010111111111111111111111111111
1101111111111111111111111111111111111111111111111111111111111111111111111111111111111111111111111111
1111111111111111111111111111111011111001111111111111111111111111111111111111111111111111111111111111
1111111111111111111111111111111101100011111100100111111111111111111111111111111111111111111111111111
1111111111111111111111111111111111111111111111111111111111111111111111101111111111111111111111111111
1111111000111111111100111111111111111111111111111111111111111111111111111111111111100100111110111110
1111111111111110111111111111111111111111111111011110111111111111101111111111111111111111111111101101
1111111111110111111111111111111111111111111111111111111111111111111111111111111111111111111111111111
1111111111111111111111111111110111011111111111111111111111111111111111011111111111111111111111111111
1111111111111111111111111111011111111111111111111110110111111111111111111111111111111111111111110011
1101111111111111111111101111111111111111111111100101111110111111111111111111111111111111111101100111
1111110111111111111011111111001001111111111111111111111111111111111111111111111111111111100010011101
1111111111111111111111111111111111111111111111111111111111100111111111111111111111111111111111111111
1111111111111111111111011111111111111111111111111111111111111111111111011111111111111111111111111111
1110110001111111111111111111111111111111111111111111111111111111111111110001001111111111111111111111
0111111111111000001111111111111111111111111111111111111111111111111111111111111111111011101111111111
1111111111111001110001111101111111111111111111111111111110001111111111101111111111111111111111110111
1111111111111111111111111111111111110001111111111111111111111111111111111111111111111111111111111111
1111111111111111111111111111111111111111111111111111111111111111111111111111111111111111111111111111
1000111111111111111111111101111111111111111111111111111111111111111111111111111111111111111111111111
1111111111111111111111111111111111110000011111110100011011111111111111111111111111111111111111111111
1111111111111111111111111111111111111111111111111111111111111111111111111111111111111111111111111111
111101111011111111101111111111010111001111111011111

1111000111111111111111111111111110001011011110101100100100111111111000001110101011111110011111100111
1111111111111111111111111111111111111111111111111110111010001110001110100111111001111111111111111111
1111111111111111111111010111111111101111110011111011111111111111111111111111111111111111111111001000
1111111111111111111111111110111111111111111110110000111111101111111111010111111111111111101110110111
1101111111111111111111111111111111111111111111111111111111111111111111110111111111111111111101001000
0101001110011111111111111111010001110001101111111111111111111111111111111111111101111110011101111111
1111111111111111111101111010001001000011111100100111111111111111111111111111111111111111111111111111
1111111111111101111111111111110111111111111011111001001111111111111111000111011111111111101110111101
1000110000111110101100110000111111111111111111111111001111111111111111111111110000100000111110011010
1111011101111110110110111111111111111111010101011110111111111111100011111011111111100111111001001101
1111111111100111111111111111111111111111111111111111111111011111011111111111110011010111000110001111
0111111011011110111110111110110111011111100011111111111111011000001011011111111111011101111111101111
1001111111111001100111111100010000111111111110100010110111111111111111111100000111111111100110110010
1000111111111111111100101111111111111101011111000101111110011111111111111111111111101100011001100101
1010100111111111000010111100001001111111111111111111111111111110111101011111111010011010100000011101
1111101100010111111111111001111100111111111111111111110111000111111111111111111111111111111001111111
1111111111110101100000011111111111111111111101100111111111111111100110011111111111110111111111111111
1100110001111001111111111111111101111111111111111000100011101011111110100001001001110111111110011101
0101111111011000001111110011111111111111111111111110101111000101111110111111101010111011101111111111
1011110110101000110001101000011110111111111111111111101000001011111111001111111111111111111111010101
1101111111111111111111111111111111100001101101001101011111011111110111110111111111111111111111111111
1111111111111111111111111111110000001101111101111111111111111111111111111111111011111111010011111011
0000110111101100001110110100011111111111110101101111011011111111111111111111110111111111110011111111
0111111111111111111101111101001100010000011111100100011011111101111111111111111111111111111111101111
1111000011111111111111111111110111101011111111111111111111001111111111111111011111111111000110011011
111001110011100111100111111100010011001111101011111